
 EA ./texture/brick_wall.xpm
 NO           ./texture/brick_wall.xpm



 SO ./texture/brick_wall.xpm


C 80,            150        ,230
 WE        ./texture/brick_wall.xpm


		S  ./texture/brick_wall.xpm
F  80,     230 ,                150



11111111111111
11000000000011
11000000000011
11001000000011
11000000000011
11000000000011
11000000100011
11000000000011
11000000000011
11000000000011
11000000001111
1100N000000011
11000000000011
11111111111111
