EA ./textures/64.xpm
NO ./textures/128.xpm
SO ./textures/32.xpm
WE ./textures/256.xpm

SO ./textures/32.xpm

C 100, 100, 100

F 50, 50, 50

111111111111111111111
100000000000000000001
100000000000000000001
100000000000000000001
100000000000000000001
100000000000000000001
100000000000000000001
100000000000000000001
100000000000000000001
100000000000000000001
100000000000000001111
100000000000000001111
100000000000000001111
100000000000000000001
100000000000000000001
100000000000000000001
100000000000000000001
100000000000000000001
100000000000000000001
1N0000000000000000001
111111111111111111111
10001
10001
10001
11111
